aardvark : abdomens ,aberrant ,aardwolf ,abandons 
aardwolf : aberrant ,aardvark ,abductor ,abattoir 
aaron : abbot ,abbey ,abash ,abaft 
aback : abeam ,abele ,abase ,abate 
abacus : abates ,abates ,abduct ,abbeys 
abaft : abash ,abate ,abase ,abbey 
abalone : abandon ,abdomen ,abashed ,abducts 
abandon : abalone ,abdomen ,abashed ,abducts 
abandoned : abdicates ,abdicated ,abdominal ,abasement 
abandonment : abbreviates ,abbreviated ,abductions ,aberration 
abandons : abdomens ,aardvark ,aberrant ,aardwolf 
abase : abate ,abaft ,abash ,abele 
abased : abated ,abacus ,abates ,abates 
abasement : abatement ,abatement ,abdominal ,abduction 
abash : abaft ,abate ,abase ,abbey 
abashed : abalone ,abandon ,abdomen ,abducts 
abate : abaft ,abase ,abash ,abele 
abated : abased ,abacus ,abates ,abates 
abatement : abatement ,abasement ,abduction ,abdominal 
abates : abates ,abacus ,abduct ,abbeys 
abattoir : abductor ,aardwolf ,aberrant ,aardvark 
abattoirs : abductors ,abduction ,abatement ,abatement 
abbe : abel ,abe ,aback ,abeam 
abbey : abash ,abaft ,abbot ,abate 
abbeys : abduct ,abbots ,abates ,abates 
abbot : abbey ,aaron ,abash ,abaft 
abbots : abbeys ,abduct ,abates ,abates 
abbreviate : abdication ,abdicating ,aberration ,aberration 
abbreviated : abandonment ,abbreviates ,abductions ,aberration 
abbreviates : abandonment ,abbreviated ,abductions ,aberration 
abbreviating : abbreviation ,abbreviates ,abandonment ,abbreviated 
abbreviation : abbreviating ,abbreviates ,abandonment ,abbreviations 
abbreviations : abbreviation ,abbreviating ,abbreviates ,abandonment 
abdicate : aberdeen ,abducted ,abandons ,abdomens 
abdicated : abandoned ,abdicates ,abdominal ,abasement 
abdicates : abandoned ,abdominal ,abdicated ,abasement 
abdicating : abdication ,abbreviate ,aberration ,aberration 
abdication : abbreviate ,abdicating ,aberration ,aberration 
abdomen : abandon ,abalone ,abashed ,abducts 
abdomens : aardvark ,abandons ,aberrant ,aardwolf 
abdominal : abdicates ,abasement ,abatement ,abatement 
abduct : abates ,abates ,abbeys ,abacus 
abducted : aberdeen ,abandons ,abdomens ,abdicate 
abduction : abatement ,abatement ,abasement ,abductors 
abductions : aberration ,aberration ,abbreviate ,abdication 
abductor : abattoir ,aardwolf ,aberrant ,aardvark 
abductors : abattoirs ,abduction ,abatement ,abatement 
abducts : abdomen ,abandon ,abalone ,abashed 
abe : abbe ,abel ,aback ,abeam 
abeam : abele ,aback ,abase ,abate 
abel : abbe ,aback ,abeam ,abele 
abele : abase ,abeam ,abate ,abaft 
aberdeen : abducted ,abdicate ,abandons ,abdomens 
aberrant : aardwolf ,aardvark ,abductor ,abdomens 
aberration : aberration ,abductions ,abbreviate ,abdication 
