aardvark : aardvark 
aardwolf : aardwolf 
aaron : aaron 
aback : aback 
abacus : abacus 
abaft : abaft 
abalone : abalone 
abandon : abandon 
abandoned : abandoned 
abandonment : abandonment 
abandons : abandons 
abase : abase 
abased : abased 
abasement : abasement 
abash : abash 
abashed : abashed 
abate : abate 
abated : abated 
abatement : abatement 
abates : abates 
abattoir : abattoir 
abattoirs : abattoirs 
abbe : abbe 
abbey : abbey 
abbeys : abbeys 
abbot : abbot 
abbots : abbots 
abbreviate : abbreviate 
abbreviated : abbreviated 
abbreviates : abbreviates 
abbreviating : abbreviating 
abbreviation : abbreviation 
abbreviations : abbreviations 
abdicate : abdicate 
abdicated : abdicated 
abdicates : abdicates 
abdicating : abdicating 
abdication : abdication 
abdomen : abdomen 
abdomens : abdomens 
abdominal : abdominal 
abduct : abduct 
abducted : abducted 
abduction : abduction 
abductions : abductions 
abductor : abductor 
abductors : abductors 
abducts : abducts 
abe : abe 
abeam : abeam 
abel : abel 
abele : abele 
aberdeen : aberdeen 
aberrant : aberrant 
aberration : aberration 
aberrations : aberrations 
abet : abet 
abets : abets 
abetted : abetted 
abetting : abetting 
abeyance : abeyance 
abhor : abhor 
abhorred : abhorred 
abhorrence : abhorrence 
abhorrent : abhorrent 
abhors : abhors 
abide : abide 
abided : abided 
abides : abides 
abiding : abiding 
abidjan : abidjan 
abies : abies 
abilities : abilities 
ability : ability 
abject : abject 
abjure : abjure 
abjured : abjured 
ablates : ablates 
ablating : ablating 
ablation : ablation 
ablative : ablative 
ablebodied : buzzwords 
abler : abler 
abloom : abloom 
ablution : ablution 
ablutions : ablutions 
ably : ably 
abnegation : abnegation 
abnormalities : abnormalities 
abnormality : abnormality 
abnormally : abnormally 
abode : abode 
abodes : abodes 
abolish : abolish 
abolished : abolished 
abolishes : abolishes 
abolishing : abolishing 
abolition : abolition 
abolitionist : abolitionist 
abolitionists : abolitionists 
abomb : abomb 
abominable : abominable 
abominably : abominably 
abominated : abominated 
abomination : abomination 
abominations : abominations 
aborigines : aborigines 
abort : abort 
aborted : aborted 
abortionist : abortionist 
abortionists : abortionists 
abortive : abortive 
aborts : aborts 
abounding : abounding 
abounds : abounds 
about : about 
above : above 
abraded : abraded 
abraham : abraham 
abrasions : abrasions 
abrasive : abrasive 
abrasively : abrasively 
abrasiveness : abrasiveness 
abrasives : abrasives 
abridged : abridged 
abridgement : abridgement 
abrogate : abrogate 
abrogated : abrogated 
abrogation : abrogation 
abrogations : abrogations 
abrupt : abrupt 
abruptly : abruptly 
abruptness : abruptness 
abscess : abscess 
abscesses : abscesses 
abscissae : abscissae 
abscond : abscond 
absconded : absconded 
abseiled : abseiled 
abseils : abseils 
absence : absence 
absences : absences 
absent : absent 
absenteeism : absenteeism 
absenting : absenting 
absently : absently 
absentmindedly : absentmindedly 
absentmindedness : acknowledgements 
absolute : absolute 
absolutely : absolutely 
absoluteness : absoluteness 
absolutes : absolutes 
absolution : absolution 
absolutism : absolutism 
absolutist : absolutist 
absolutists : absolutists 
absorbency : absorbency 
absorbers : absorbers 
absorbingly : absorbingly 
absorption : absorption 
absorptions : absorptions 
absorptive : absorptive 
absorptivity : astrophysics 
abstains : abstains 
abstemious : abstemious 
abstemiousness : administrators 
abstention : abstention 
abstentions : abstentions 
abstinence : abstinence 
abstinent : abstinent 
abstracted : abstracted 
abstractedly : abstractedly 
abstracting : abstracting 
abstractions : abstractions 
abstractly : abstractly 
abstruse : abstruse 
abstrusely : apportions 
absurd : absurd 
absurder : absurder 
absurdest : absurdest 
absurdities : absurdities 
absurdity : absurdity 
absurdly : absurdly 
abundance : abundance 
abuse : abuse 
abused : abused 
abuser : abuser 
abusers : abusers 
abuses : abuses 
abusing : abusing 
abusive : abusive 
abusively : abusively 
abusiveness : abusiveness 
abut : abut 
abutment : abutment 
abutments : abutments 
abuzz : abuzz 
aby : aby 
abysmally : abysmally 
abyss : abyss 
abysses : abysses 
acacia : bagdad 
academe : academe 
academia : bandaged 
academic : academic 
academical : backhanded 
academically : alphabetical 
academician : academician 
academicians : braindamaged 
academics : academics 
academy : academy 
acanthus : acanthus 
accede : accede 
acceded : baghdad 
acceding : acceding 
accelerate : accelerate 
accelerated : amalgamated 
accelerates : accelerates 
accelerating : accelerating 
acceleration : acceleration 
accelerations : accelerations 
accelerator : accelerator 
accelerators : accelerators 
accelerometer : accreditation 
accelerometers : accelerometers 
accented : accented 
accenting : accenting 
accentuated : accentuated 
accentuation : accentuation 
acceptability : acceptability 
acceptable : acceptable 
acceptance : acceptance 
acceptances : acceptances 
acceptor : acceptor 
acceptors : acceptors 
access : access 
accessed : accessed 
accessibility : accessibility 
accession : accession 
accessions : accessions 
accessories : accessories 
accessory : accessory 
accidence : accidence 
accidental : accidental 
accidentally : accidentally 
accidentprone : accidentprone 
acclaim : acclaim 
acclaimed : acclaimed 
acclaims : acclaims 
acclamations : acclamations 
acclimatisation : acknowledgement 
acclimatise : acclimatise 
acclimatised : acclimatised 
acclimatising : bidirectional 
accolade : accolade 
accolades : accolades 
accommodate : accommodate 
accommodated : accommodated 
accommodates : acclamations 
accommodating : accommodating 
accommodations : accompaniments 
accompanied : accompanied 
accompanies : accompanies 
accompaniments : absentmindedly 
accompanying : accompanying 
accomplice : accomplice 
accomplished : accomplished 
accomplishes : accomplishes 
accomplishing : accomplishing 
accomplishment : accomplishment 
accomplishments : biotechnologist 
accord : accord 
accordance : accordance 
accorded : accorded 
according : according 
accordingly : accordingly 
accordion : accordion 
accordions : accordions 
accords : accords 
accosts : accosts 
account : account 
accountability : accountability 
accountancy : accountancy 
accountant : accountant 
accountants : accountants 
accra : accra 
accredit : accredit 
accreditation : accelerometer 
accrual : accrual 
accrued : accrued 
accumulate : accumulate 
accumulates : accumulates 
accumulating : accumulating 
accumulation : accumulation 
accumulations : accumulations 
accumulative : accumulative 
accumulator : accumulator 
accumulators : accumulators 
accuracies : accuracies 
accuracy : accuracy 
accurately : accurately 
accusation : accusation 
accusations : accusations 
accusatory : accusatory 
accused : accused 
accusers : accusers 
accuses : accuses 
ace : ace 
aced : aced 
acerbity : acerbity 
acers : acers 
acetal : acetal 
ache : ache 
achieve : achieve 
achievement : achievement 
achievements : achievements 
achromatic : achromatic 
achy : achy 
acidic : acidic 
acidification : beneficiaries 
acidified : acidified 
acidifying : acidifying 
acknowledge : acknowledge 
acknowledged : acknowledged 
acknowledgement : acclimatisation 
acknowledgements : bureaucratically 
acknowledges : acknowledges 
acknowledgments : acknowledgments 
acme : acme 
acne : acne 
acolyte : acolyte 
acolytes : acolytes 
acorn : acorn 
acorns : acorns 
acoustic : acoustic 
acquaintances : acquaintances 
acquainted : acquainted 
acquiesce : acquiesce 
acquiescence : acquiescence 
acquiescent : acquiescent 
acquiescing : acquiescing 
acquire : acquire 
acquirers : acquirers 
acquires : acquires 
acquisition : acquisition 
acquisitions : acquisitions 
acquisitive : acquisitive 
acquisitiveness : acquisitiveness 
acquit : acquit 
acquittals : acquittals 
acre : acre 
acrimoniously : acrimoniously 
acrobatic : acrobatic 
acronym : acronym 
acronyms : acronyms 
acrostics : acrostics 
acrylics : acrylics 
act : act 
actinides : actinides 
action : action 
actionable : actionable 
activated : activated 
activations : activations 
active : active 
actively : actively 
activist : activist 
activists : activists 
activities : activities 
activity : activity 
actor : actor 
actors : actors 
acts : acts 
actualisation : actualisation 
actuality : actuality 
actuator : actuator 
actuators : actuators 
acuity : acuity 
acupuncture : acupuncture 
acupuncturist : automorphisms 
acupuncturists : astrophysicist 
acute : acute 
acutely : acutely 
acuter : acuter 
adages : adages 
adam : adam 
adapt : adapt 
adaptable : adaptable 
adaptively : adaptively 
adaptor : adaptor 
addenda : addenda 
adder : adder 
addiction : addiction 
addictions : addictions 
addictive : addictive 
addictiveness : addictiveness 
adding : adding 
additions : additions 
additively : additively 
additives : additives 
addled : addled 
addles : addles 
addressability : absentmindedly 
addresses : addresses 
adduce : adduce 
adelaide : balanced 
aden : aden 
adhered : adhered 
adiabatically : acidification 
adieux : adieux 
adipose : adipose 
adit : adit 
adjacency : adjacency 
adjacent : adjacent 
adjoin : adjoin 
adjoined : adjoined 
adjoins : adjoins 
adjourn : adjourn 
adjudicated : ballbearing 
adjudicating : adjudicating 
adjudications : adjudications 
adjudicator : adjudicator 
adjustments : adjustments 
adjusts : adjusts 
admen : admen 
admin : admin 
administering : administering 
administrating : anticoagulants 
administration : administration 
administrations : antidepressants 
administrative : administrative 
administratively : antiabortionists 
administrator : administrator 
administrators : administrators 
admissibility : admissibility 
admissions : admissions 
admittance : admittance 
admittances : admittances 
admonishment : admonishment 
admonitory : admonitory 
ado : and 
adolescence : adolescence 
adore : adore 
adorn : adorn 
adorning : adorning 
adroitly : adroitly 
adulatory : adulatory 
adult : adult 
adulterates : adulterates 
adulteration : adulteration 
adulterations : adulterations 
adulteresses : adulteresses 
adulterous : adulterous 
adultery : adultery 
adults : adults 
adumbrating : adumbrating 
advancement : advancement 
advantaged : abdication 
advantageously : administration 
adventurers : adventurers 
adventurous : adventurous 
adventurously : archaeological 
adversity : adversity 
advertisement : advertisement 
advertisements : advertisements 
advertisers : advertisers 
advised : advised 
advisory : advisory 
adze : adze 
aeon : aeon 
aeons : aeons 
aerodynamically : approachability 
aerodynamics : aerodynamics 
aesthetes : aesthetes 
aesthetically : aesthetically 
aestheticsy : aestheticsy 
afar : afar 
affidavits : affidavits 
affiliate : affiliate 
affiliating : affiliating 
affirmatively : affirmatively 
afforestation : agglutinative 
afire : afire 
afloat : afloat 
aforementioned : accommodations 
aforethought : aforethought 
aft : aft 
aftereffects : aftereffects 
aftershave : aftershave 
afterthought : afterthought 
afterthoughts : afterthoughts 
agakhan : agakhan 
age : age 
ageing : ageing 
ageings : ageings 
ages : ages 
agglomerations : agglomerations 
agglutinative : affirmatively 
aggravated : aggravated 
aggravating : aggravating 
aggravation : aggravation 
aggregated : aggregated 
aggregating : aggregating 
aggressiveness : advantageously 
aghast : aghast 
agile : agile 
agitated : agitated 
agnosticism : agnosticism 
ago : ago 
agog : agog 
agonisingly : agonisingly 
agony : agony 
agouti : agouti 
agreeable : agreeable 
agreeableness : agrochemicals 
agribusiness : agribusiness 
agriculturalist : acquisitiveness 
agriculturalists : antiabortionists 
agrochemical : agrochemical 
agrochemicals : agrochemicals 
agronomists : amputations 
ah : be 
aha : aha 
ahead : ahead 
ahoy : ahoy 
aid : aid 
aided : aided 
aidedecamp : aidedecamp 
aidesdecamp : aidesdecamp 
aids : aids 
ail : ail 
ails : ails 
aims : aims 
airconditioned : accelerometers 
airconditioner : accountability 
airconditioning : aerodynamically 
airfield : airfield 
airflow : airflow 
airily : airily 
airplay : airplay 
airport : airport 
airports : airports 
airs : airs 
airstrip : airstrip 
airstrips : airstrips 
airways : airways 
airworthiness : apportionment 
airworthy : airworthy 
airy : airy 
alabama : academe 
alb : alb 
albeit : albeit 
ale : ale 
alertly : alertly 
alfalfa : alfalfa 
alga : alga 
algebraical : algebraical 
algebraically : ascertainable 
algebras : algebras 
algorithmically : acknowledgments 
alibaba : alibaba 
alimentary : alimentary 
aliquot : aliquot 
aliquots : aliquots 
alkyl : alkyl 
all : all 
allegiance : allegiance 
allegiances : allegiances 
allegorically : apathetically 
alleviations : alleviations 
alley : alley 
alliterating : alliterating 
alliteration : alliteration 
allocators : allocators 
allot : allot 
allow : allow 
allows : allows 
alloy : alloy 
alloys : alloys 
allure : allure 
allures : allures 
allusive : allusive 
alluvium : alluvium 
ally : ally 
almost : almost 
alms : alms 
aloofness : aloofness 
aloud : aloud 
alp : alp 
alpaca : alpaca 
alphabetic : alphabetic 
alphabetical : academically 
alphabetically : breathingspace 
alps : alps 
alt : alt 
altercation : altercation 
altercations : altercations 
alternatives : alternatives 
altruist : altruist 
altruistically : abstemiousness 
alts : alts 
alumnus : alumnus 
always : always 
am : an 
amalgam : amalgam 
amalgamated : amalgamated 
amalgamation : acceleration 
amateurishness : advertisements 
amateurism : amateurism 
ambassadorial : ambassadorial 
ambiance : ambiance 
ambidextrous : ambidextrous 
ambience : ambience 
ambiguously : ambiguously 
ambivalence : ambivalence 
amendable : amendable 
amethystine : amethystine 
amethysts : airstrips 
amity : amity 
amorous : amorous 
amorously : amorously 
amorphous : amorphous 
amortisation : amortisation 
amounts : amounts 
amours : amours 
amp : amp 
ampersands : ampersands 
amphitheatres : amphitheatres 
amply : amply 
amputation : amputation 
amputations : amputations 
amulet : amulet 
amulets : amulets 
amusingly : amusingly 
an : am 
ana : alb 
anachronistically : anthropogenically 
anaerobic : anaerobic 
anaesthetists : anaesthetists 
anagrammatic : anagrammatic 
anagrammatically : biotechnological 
analyst : analyst 
and : and 
androgynous : androgynous 
aneurysms : aneurysms 
angrily : angrily 
anhydrous : anhydrous 
anisotropies : anisotropies 
anisotropy : anisotropy 
anniversaries : anniversaries 
announcements : announcements 
annoy : annoy 
annoys : annoys 
annuity : annuity 
anonymity : anonymity 
anonymously : braindamaged 
answers : answers 
ant : asp 
anteriorly : anteriorly 
anthologised : anthologised 
anthropocentric : apprenticeships 
anthropogenically : bureaucratisation 
anthropologist : anthropologist 
anthropologists : authoritatively 
anthropology : bloodthirsty 
anthropometric : anthropometric 
anthropomorphic : agriculturalist 
anthropomorphising : anticonstitutional 
anthropomorphism : agriculturalists 
antiabortionists : administratively 
anticipations : anticipations 
anticlockwise : anticlockwise 
anticoagulants : administrating 
anticonstitutional : anthropomorphising 
antidepressant : administration 
antidepressants : administrations 
antihistamines : antihistamines 
antioxidants : antioxidants 
antiquities : antiquities 
antisymmetric : antisymmetric 
antisymmetry : biodegradable 
antithetical : antithetical 
antithetically : antithetically 
antitrust : arrowroot 
antonyms : altruist 
ants : ants 
anus : anus 
anxiety : anxiety 
anxiously : anxiously 
any : any 
anyhow : anyhow 
anyway : anyway 
anyways : autumns 
apathetically : apathetically 
apex : apex 
apologetically : apologetically 
apologists : apologists 
apostles : apostles 
apostrophes : androgynous 
apostrophised : abolitionists 
applicability : accessibility 
apply : apply 
appointments : abortionists 
apportion : apportion 
apportionment : approximately 
apportions : apportions 
appreciations : appreciations 
appreciatively : antihistamines 
apprehending : apprehending 
apprehensive : alleviations 
apprenticeships : anthropocentric 
approachability : aerodynamically 
appropriately : appropriately 
appropriations : anthropologist 
approvals : approvals 
approves : approves 
approvingly : approvingly 
approximated : approximated 
approximately : approximately 
approximates : approximates 
approximating : abolitionists 
approximation : appropriately 
approximations : anthropologist 
apron : apron 
aprons : aprons 
apropos : apropos 
apt : apt 
aptly : aptly 
arachnophobia : arachnophobia 
arak : arak 
arbitrariness : arbitrariness 
arbitrators : arbitrators 
arcadia : arcadia 
archaeological : adventurously 
archaeologically : biotechnological 
archaeologists : archaeologists 
archdeaconry : archdeaconry 
archdeacons : archdeacons 
architectural : abnormalities 
architecturally : atmospherically 
area : area 
argumentative : argumentative 
argumentatively : acquisitiveness 
aria : aria 
arm : arm 
armourers : armourers 
armoury : armoury 
arms : arms 
army : army 
arrow : arrow 
arrowroot : antitrust 
arrows : arrows 
arsonists : arsonists 
art : art 
articulations : administrator 
articulatory : appointments 
artistry : augustus 
artists : artists 
artlessly : artlessly 
artlessness : artlessness 
arts : arts 
artworks : autonomy 
arty : buoy 
as : at 
ascertainable : ascertainable 
ask : ask 
asp : asp 
assailable : assailable 
assassinations : administrators 
assertions : absolutist 
assiduity : assiduity 
assiduously : assumptions 
assistants : assistants 
associative : associative 
assort : assort 
assortment : apportions 
assortments : assiduously 
assumption : astronauts 
assumptions : assiduously 
astrology : astrology 
astronauts : astronauts 
astronomically : asymmetrically 
astrophysical : apostrophised 
astrophysicist : acupuncturists 
astrophysicists : anthropologists 
astrophysics : astrophysics 
astutely : autonomy 
asylum : asylum 
asylums : asylums 
asymmetrically : asymmetrically 
asymptomatic : asymptomatic 
asymptotes : anisotropy 
asymptotically : approximations 
asynchronously : acupuncturists 
at : as 
ate : aft 
atherosclerosis : administrations 
atmospherically : apprenticeships 
atrociously : absolutists 
attempting : attempting 
attentiveness : acrimoniously 
attenuators : attenuators 
attest : attest 
attorney : boycotts 
attributions : attributions 
augury : augury 
augustus : artistry 
aunt : aunt 
auspiciously : astrophysics 
austerity : airworthy 
authenticated : adjudications 
authentication : antihistamines 
authorisation : antisymmetric 
authoritarianism : biotechnologists 
authoritatively : anthropologists 
autobiographical : anagrammatically 
autobiographically : anthropomorphising 
automorphisms : acupuncturist 
autonomous : asymptotes 
autonomously : backpedalling 
autonomy : autonomy 
autopsy : autopsy 
autosuggestion : asymptotically 
autumn : autumn 
autumns : anyways 
availabilities : bibliographies 
avow : avow 
awn : apt 
awry : awry 
axons : axons 
azure : azure 
baa : cab 
baal : baal 
babble : babble 
babbling : babbling 
bach : aced 
backache : backache 
backbencher : algebraical 
backbenchers : backbenchers 
backdate : acceding 
backed : backed 
backfired : backfired 
backhanded : academical 
backing : backing 
backpedal : backpedal 
backpedalled : anonymously 
backpedalling : autonomously 
backspace : backspace 
backtrack : backtrack 
backtracked : aidesdecamp 
backtracking : acclimatised 
bactericidal : blackballing 
bacteriological : biogeographical 
bacteriologists : biotechnologist 
bad : abe 
bade : bade 
badged : badged 
badinage : badinage 
baffled : abraded 
bagdad : acacia 
baggage : baggage 
baghdad : alibaba 
bah : bah 
balance : balance 
balanced : adelaide 
baled : baled 
ballbearing : accompanied 
ballbearings : ballbearings 
ban : ale 
bandage : abraded 
bandaged : bandaged 
bandanna : abridged 
bar : bar 
barefaced : accidence 
barricaded : barricaded 
bawl : bawl 
be : ah 
beachcomber : accelerated 
beachhead : artistry 
beaked : beaked 
beanie : beanie 
beatifications : beatifications 
bee : age 
beef : ache 
beleaguered : accompanied 
belt : belt 
benefactions : benefactions 
beneficial : beneficial 
beneficiaries : beneficiaries 
bibliographical : biogeographical 
bibliographies : availabilities 
bicarb : bicarb 
bidirectional : acclimatising 
biochemically : accommodating 
biodegradable : antisymmetry 
biogeographical : bacteriological 
biographically : airconditioned 
biosynthesis : articulatory 
biotechnological : anagrammatically 
biotechnologist : bacteriologists 
biotechnologists : authoritarianism 
blackballed : academician 
blackballing : bactericidal 
blackjack : backpedal 
blackmailed : backbencher 
blackmailing : agrochemical 
blameable : blackjack 
bleach : abased 
bleached : bleached 
bloodthirstiest : argumentatively 
bloodthirsty : anthropology 
bloodymindedness : bureaucratically 
blurry : bounty 
blurs : blurs 
blustery : blustery 
boastfulness : boastfulness 
boisterously : biodegradable 
bootstraps : bootstraps 
booty : booty 
borrowers : arsonists 
borrowings : borrowings 
bossy : bossy 
bounty : bounty 
bows : bows 
box : box 
boxy : boxy 
boy : boy 
boycotts : boycotts 
braindamaged : anonymously 
breadandbutter : beatifications 
breathingspace : alphabetically 
breathtaking : apprehending 
bridgebuilding : alphabetically 
bridgehead : aidedecamp 
bristly : bristly 
broadmindedness : acclimatisation 
brontosaurus : antisymmetry 
brutus : bursts 
buckminsterfullerene : anticonstitutional 
buoy : buoy 
buoys : buoys 
bureaucratically : acknowledgements 
bureaucratisation : anthropogenically 
burly : booty 
burrows : autopsy 
burs : avow 
bursts : bursts 
bust : bust 
busts : bossy 
busty : buoys 
but : boy 
buy : but 
buyout : brutus 
buzz : awry 
buzzards : airports 
buzzer : bounty 
buzzwords : ablebodied 
by : at 
byways : arrows 
cab : bad 
cabbage : acceded 
cabled : backed 
cache : cache 
cafe : baal 
calcified : acclaimed 
